00000000000000000000000000
00000000000000000000000000
00001111110000001111110000
00001111110000001111110000
00001111110000001111110000
00001111110000001111110000
00001111111111111111110000
00001111111111111111110000
00001111110000001111110000
00001111110000001111110000
00001111110000001111110000
00001111110000001111110000
00000000000000000000000000
00001111111000001111111000
00001111111110011111111100
00001111111110011111111000
00000111111111111111110000
00000011111111111111100000
00000001111111111110000000
00000000011111111000000000
00000000001111100000000000
22200000000011000000000222
00000000000000000000000000
00000011001111110011000000
00000011001100110011000000
00000011001100110011000000